TILEMAP
8 24 	-- Size of tile map in tiles
8 8 	-- Tile size & block size
16 6
0
##MONEY:
########
########
########
##MONEY:
########
########
########
#DAMARIS
########
###16###
########
#EDGAR##
########
##00####
########
########
########
########
########
########
########
########
########

