TILEMAP
24 72 								-- Size of tile map in tiles
8 8 							    -- Tile size & block size
16 6 								-- Number of tiles in tilesheet
1									-- Bank Number
************************
*                      *
*                      *
*                      *
*                      *
*                      *
*                      *
*                      *
*                      *
*                      *
*                      *
*                      *
*                      *
*                      *
*                      *
*                      *
*                      *
*                      *
*                      *
*                      *
*                      *
*                      *
*                      *
**                    **
**                    **
*                      *
*                      *
*                      *
*                      *
*                      *
*                      *
*                      *
*                      *
*                      *
*                      *
*                      *
*                      *
*                      *
*                      *
*                      *
*                      *
*                      *
*                      *
*                      *
*                      *
*                      *
*                      *
*****           ********
*****           ********
*                      *
*                      *
*                      *
*                      *
*                      *
*                      *
*                      *
*                      *
*                      *
*                      *
*                      *
*                      *
*                      *
*                      *
*                      *
*                      *
*                      *
*                      *
*                      *
*                      *
*                      *
*                      *
************************

