TILEMAP
32 72 								-- Size of tile map in tiles
8 8 							    -- Tile size & block size
16 6 								-- Number of tiles in tilesheet
1									-- Bank Number
************************##MONEY:
*                      *#0000000
*            *****     *########
*     ******           *########
*          *****       *########
*                      *#POINTS:
*    ********          *#0000000
*                      *########
*     ********         *########
*                      *########
*     **   **********  *##LIVES:
*      ******          *######01
*                      *########
*   *********          *########
*                      *###BANK:
*          ***         *######01
*    *                 *########
*    *                 *########
*    *        ******   *#BATMODE
*    *  ********       *##SMALL#
*                      *########
*   ******             *###ROOM:
*                      *######03
************************########
************************##MONEY:
*  ******************* *#0000000
*                      *########
*                      *########
*                      *########
*  ***********         *#POINTS:
*                      *#0000000
*                      *########
*     **************** *########
*                      *########
*                      *##LIVES:
*      **********      *######01
*                      *########
*                      *########
*     **************   *###BANK:
*                      *######01
*                      *########
*                      *########
*                      *#BATMODE
*                      *##SMALL#
*                      *########
*                      *###ROOM:
*                      *######02
************************########
************************##MONEY:
*                      *#0000000
*                      *########
*                      *########
*      **************  *########
*                      *#POINTS:
*                      *#0000000
*  ****************    *########
*                      *########
*                      *########
*       *************  *##LIVES:
*                      *######01
*                      *########
*                      *########
*                      *###BANK:
*                      *######01
*                      *########
*                      *########
*                      *#BATMODE
*                      *##SMALL#
*                      *########
*                      *###ROOM:
*                      *######01
************************########

